1111111111
1000100001
1011111001
1000000001
10000X0101
1010000101
1010000101
1011111101
1000000001
1111111111