11111111111
10000000001
10200200201
10000000001
10000000001
102002002X1
10000000001
10000000001
10200200201
10000000001
11111111111