   #### ########                              #### ####    ###                           
  #....#........# ####                       #....#....#  #...#  ##########              
  #.##...######.##....#       #######       #..##...##.# #..#..##..........#             
  #..####     #..#....#      #.......#     #..#  ###...# #.# #.............#             
   #..#       ##......#      #.......#     #.#     #.####..#  #.#..........#             
    #..#     #...#....#      #.......#     #.#     #.#....#####.###########              
     #..#    #.###....#      #.......#     #.#     #.#.####.....#                        
      #.#    #.# #....#      #.......#     #.#     #.#.#  #.####                         
       #     #..# ####       #.......#    #..#   ##..#.#  #.#                            
              #..##...#       #.#####     #.#   #...#..#  #.#                            
               #.##.#.#       #...##      #.#   #.###.#   #.#                            
              #..##.#..#      #.#...#   ###.#   #.....#   #.#   #####                    
              #.#...##..######..###..# #....###########   #.#  #.....#                   
              #...##  #........#####.###.####..........#  #.#  #.....#                   
               #.###############.....#...#  #..........#  #..# #.....#                   
              #........#       #.#####.##   #..........#   #.# #.....#                   
              #........#       #.......#    #..........#   #.# #.....#                   
              #........#      ##.######     #..........#   #.# #.....#                   
              #........#     #........#     #..........#   #..##.....#                   
              #........#     #........#     #..........# ####........#                   
              #........#     #........#     #..........##....#.######                    
              #........#     #........#     #..........#..##...#####                     
              #........#     #........#     #..........#.#######....#                    
              #........#      ########      #............#...##..##.###                  
               ########                      ###########...#....# #....#                 
                                                        ### ####   ####                  


